....:..:≈......:
:.....:.≈.::....
:.......≈..:..:.
..:.:..:≈:......
....:..:≈......:
:.....:.≈.::....
:.......≈..:..:.
..:.:..:≈:......
