....:..:.......:
:.....:...::....
:..........:..:.
..:.:..:.:......
....:..:.......:
:.....:...::....
:..........:..:.
..:.:..:.:......
